ARPANET: Versi internet paling awal dari yang kita lihat saat ini, yang dibuat oleh proyek pemerintah Amerika Serikat bernama DARPA pada tahun 1960-an

Children's Online Privacy Protection Act (COPPA): Mengatur informasi yang boleh ditampilkan kepada anak-anak berusia di bawah 13 tahun

Klien:Perangkat yang menerima data dari server

DARPA:Sebuah proyek pemerintah AS pada tahun 1960-an yang menciptakan versi Internet paling awal yang kita lihat saat ini

Nama domain:Nama situs; bagian URL setelah www.

Domain Name System (DNS): Layanan jaringan global dan sangat terdistribusi yang me-resolve string huruf, seperti nama situs, ke alamat IP

Kabel Ethernet: Dengan kabel ini, Anda dapat terhubung ke jaringan secara fisik melalui kabel

Kabel fiber optik: Kabel fiber optik berisi setiap serat optik yang berbentuk tabung kaca kecil selebar rambut manusia. Tidak seperti tembaga, yang menggunakan tegangan listrik, kabel serat menggunakan pulsa cahaya untuk mewakili angka satu dan nol pada data yang mendasarinya

Globalisasi: Gerakan yang memungkinkan pemerintah, bisnis, dan organisasi berkomunikasi dan berintegrasi bersama dalam skala internasional

Hub: Perangkat yang berfungsi sebagai lokasi terpusat yang dilalui data

Internet: Sistem jaringan yang saling terhubung di seluruh dunia

Internet Corporation for Assigned Names and Numbers (ICANN): Tempat nama situs terdaftar

Internet of Things (IoT): Konsep bahwa makin banyak perangkat yang terhubung ke internet dengan cara yang lebih cerdas, seperti termostat pintar yang mematikan AC saat Anda pergi dan menyalakannya saat Anda kembali

Alamat IP versi 4 (IPv4): Alamat yang terdiri dari 32 bit yang dibagi menjadi empat grup

Alamat IP versi 6 (IPv6): Alamat yang terdiri dari 128 bit, empat kali dari jumlah yang digunakan IPv4

Internet Service Provider (ISP): Perusahaan yang menyediakan koneksi internet kepada konsumen

Alamat IP: Protokol paling umum yang digunakan di lapisan jaringan, yang digunakan untuk membantu merutekan informasi

Alamat MAC: ID unik yang secara global dikaitkan dengan antarmuka jaringan individu. Ini adalah angka 48-bit yang biasanya diwakili oleh enam grup berisi dua angka heksadesimal

Jaringan: Interkoneksi komputer

Penafsiran Alamat Jaringan (NAT): Alat mitigasi yang memungkinkan organisasi menggunakan satu alamat IP publik dan banyak alamat IP pribadi dalam jaringan

Jejaring: Mengelola, membangun, dan mendesain jaringan

Protokol jejaring: Serangkaian aturan tentang cara mentransfer data dalam jaringan

Stack jaringan: Serangkaian hardware atau software yang menyediakan infrastruktur untuk komputer

Router: Perangkat yang mengetahui cara meneruskan data antara jaringan yang independen

Log server: File teks yang berisi informasi yang direkam tentang aktivitas yang dilakukan di server web tertentu dalam jangka waktu tertentu

Server: Perangkat yang menyediakan data ke perangkat lain yang meminta data tersebut, juga dikenal sebagai klien

Tombol: Perangkat yang membantu perjalanan data

Transfer Control Protocol (TCP): Protokol yang menangani pengiriman informasi yang andal dari satu jaringan ke jaringan lainnya

Uniform Resource Locator (URL): Alamat web yang mirip dengan alamat rumah

Serangan WannaCry: Serangan cyber yang dimulai di Eropa dan menginfeksi ratusan ribu komputer di seluruh dunia

Jaringan nirkabel (Wi-Fi): Jaringan yang terhubung dengan Anda melalui radio dan antena

World Wide Web (WWW): Sistem informasi yang memungkinkan dokumen dan referensi web lainnya diakses melalui internet


Istilah dan definisinya dari minggu-minggu sebelumnya
A

Abstraksi: Proses penyederhanaan sistem yang relatif kompleks agar mudah digunakan

Address bus: Menghubungkan CPU ke MCC dan mengirimkan lokasi data, tetapi tidak mengirimkan data itu sendiri

Algoritma: Serangkaian langkah yang memecahkan masalah tertentu

Android: Sistem operasi seluler yang berbasis Linux

Aplikasi: Program komputer yang dirancang untuk penggunaan tertentu

ASCII: Standar encoding karakter paling tua yang digunakan adalah ASCII. Karakter ini mewakili alfabet, angka, dan tanda baca dalam bahasa Inggris

ATA: Antarmuka paling umum yang digunakan hard drive untuk terhubung ke sistem

ATX (Advanced Technology eXtended): Faktor bentuk paling umum untuk motherboard

B

Kompatibel dengan versi lama: Ini berarti hardware lama kompatibel dengan hardware baru

Sistem biner: Komunikasi yang dilakukan komputer disebut sebagai sistem biner, yang juga dikenal sebagai sistem bilangan basis-2

BIOS (Basic Input Output Services): BIOS adalah software yang membantu menginisialisasi hardware di komputer kita serta membuat sistem operasi aktif dan berjalan

BIOS/UEFI: Software level rendah yang menginisialisasi hardware komputer untuk memastikan semuanya berfungsi dengan baik

Block storage: Ini meningkatkan penanganan data yang lebih cepat karena data tidak disimpan dalam satu bagian yang panjang, tetapi dalam blok sehingga dapat diakses lebih cepat

Boot: Untuk mulai menjalankan komputer

Bootloader: Program kecil yang memuat sistem operasi

BYOD (Bawa Perangkat Sendiri): Mengacu pada praktik yang mengizinkan orang untuk menggunakan perangkat pribadinya untuk bekerja

Byte: Satu grup yang terdiri atas 8 bit

C

Cache: Lokasi penyimpanan yang ditetapkan untuk data yang baru-baru ini diakses atau sering diakses. Untuk aplikasi seluler, cache merupakan tempat menyimpan semua hal yang diubah atau dibuat dengan aplikasi tersebut

Encoding karakter: Digunakan untuk menetapkan nilai biner ke karakter agar dapat dibaca oleh manusia

Siklus pengisian daya: Satu pengisian daya penuh dan pengosongan daya baterai

Chrome OS: Sistem operasi berbasis Linux yang didesain oleh Google

Komputer: Perangkat yang menyimpan dan memproses data dengan melakukan proses penghitungan

Chipset: Alat inimengatur komunikasi antara berbagai komponen di perangkat kita

Siklus clock: Saat Anda mengirimkan voltase ke kabel clock

Kecepatan clock: Jumlah maksimum siklus clock yang dapat ditanganinya dalam satu set pada jangka waktu tertentu

Kabel clock: Saat Anda mengirim atau menerima data, kabel mengirimkan voltase ke kabel clock tersebut agar CPU tahu bahwa CPU dapat mulai melakukan penghitungan

Antarmuka Command Line (CLI): Shell yang menggunakan perintah teks untuk berinteraksi dengan sistem operasi

File komputer: Data yang kita simpan dan file dapat berupa apa saja mulai dari dokumen word, gambar, lagu, atau apa pun

CPU: Unit pemrosesan terpusat

Soket CPU: Soket CPU adalah serangkaian pin yang menghubungkan prosesor CPU ke motherboard PC

Kriptografi: Seluruh ilmu yang mencakup praktik pengodean dan penyembunyian pesan dari pihak ketiga

D

Blok data: Data yang dapat dibagi menjadi banyak bagian dan ditulis ke berbagai bagian hard disk

Ukuran data: Metrik yang mengacu pada ukuran data, termasuk bit, byte, kilobyte, kibibyte, dan megabyte

DDR SDRAM (Double Data Rate SDRAM): Jenis RAM yang lebih cepat, membutuhkan lebih sedikit daya, dan memiliki kapasitas lebih besar daripada versi SDRAM sebelumnya

Bentuk desimal - sistem bilangan desimal Dalam sistem desimal, ada 10 kemungkinan angka yang dapat Anda gunakan mulai dari nol hingga sembilan

Desktop:Layar utama tempat kita dapat membuka file, folder, dan aplikasi

Kesenjangan digital: Kesenjangan yang makin melebar antara orang yang memiliki kemampuan literasi digital dan yang tidak memilikinya

DIMM: Dual Inline Memory Module

Port tampilan Port yang juga menghasilkan output berupa audio dan video

Distribusi: Beberapa distribusi Linux yang umum adalah Ubuntu, Debian, dan Red Hat

DRAM: Dynamic Random Access Memory

Driver: Driver berisi petunjuk yang diperlukan CPU untuk memahami perangkat eksternal seperti keyboard, webcam, printer

DVI: Kabel DVI umumnya hanya menghasilkan output berupa video

E

Pelepasan muatan listrik statis: Pelepasan muatan listrik statis adalah aliran arus listrik secara tiba-tiba dan sesaat antara dua objek bermuatan listrik yang disebabkan oleh kontak, hubungan arus pendek, atau kebocoran insulator listrik

Etcher.io
: Alat yang dapat Anda gunakan untuk memuat image penginstalan ke perangkat USB dan membuatnya dapat di-booting

External Data Bus (EDB): Ini adalah deretan kabel yang menghubungkan berbagai bagian komputer

F

Reset ke setelan pabrik: Mereset perangkat ke setelan bawaan pabrik

Ekstensi file: Bagian tambahan dari nama file yang memberi tahu nama jenis file yang ada dalam sistem operasi tertentu

Proses penanganan file: Proses penyimpanan data menggunakan program

Sistem file:Sistem yang digunakan untuk mengelola file

Finder: File manager untuk semua Mac

Folder/Direktori: Digunakan untuk mengelola file

Faktor bentuk: Cara matematis untuk mengompensasi ketidakteraturan bentuk objek dengan menggunakan rasio antara volume dan tingginya

H

Hard drive: Ini merupakan komponen memori jangka panjang yang menyimpan semua data, yang dapat mencakup musik, gambar, aplikasi

Hardware: Perangkat dan peralatan eksternal atau internal yang membantu Anda menjalankan fungsi utama

Kekurangan resource hardware: Ini mengacu pada kurangnya resource sistem seperti memori, ruang hard drive, dan lainnya

HDD (Hard disk drive): Hard disk drive atau HDD menggunakan piring berputar dan tuas mekanis untuk membaca dan menulis informasi

HDMI: Jenis kabel yang menghasilkan output berupa video dan audio

Pembuang panas: Ini digunakan untuk membuang panas dari CPU

HFS+/APFS: HFS+ adalah sistem penulisan jurnal yang dikembangkan oleh Apple Inc. dan APFS adalah sistem penulisan jurnal Apple lainnya, tetapi lebih terenkripsi

Nama host: Digunakan untuk mengidentifikasi komputer ketika perlu berkomunikasi dengan komputer lain

I

Teknologi informasi: Penggunaan teknologi digital, seperti komputer dan internet, untuk menyimpan dan memproses data menjadi informasi yang berguna

Perangkat Input/Output:Perangkat yang menjalankan input dan output, termasuk monitor, keyboard, mouse, hard disk, speaker, headset bluetooth, webcam, dan adaptor jaringan

Image penginstalan: Image sistem operasi yang dapat didownload dan digunakan untuk menginstal sistem operasi di perangkat

Kumpulan petunjuk: Daftar petunjuk yang dapat dijalankan oleh CPU

Manajemen I/O: Segala sesuatu yang dapat memberikan input atau yang dapat digunakan untuk menghasilkan output berupa data

iOS: Sistem operasi seluler yang dikembangkan oleh Apple Inc.

ITX (Information Technology eXtended): Faktor bentuk untuk motherboard yang jauh lebih kecil daripada ATX board

K

Kernel: Inti utama dari sistem operasi yang membuat proses, menjadwalkannya secara efisien, dan mengelola cara menghentikan proses

L

Land Grid Array (LGA): Ini adalah jenis soket CPU yang mencuat dari motherboard

Adaptor lightning: Salah satu jenis konektor daya, data, dan tampilan standar yang digunakan di perangkat seluler

Linux OS: Linux adalah salah satu sistem operasi open source terbesar yang banyak digunakan dalam infrastruktur bisnis dan dunia konsumen

Logic gate:Memungkinkan transistor untuk melakukan tugas yang lebih kompleks, seperti memutuskan ke mana sinyal listrik harus dialirkan yang tergantung pada kondisi logika

Log: File yang merekam peristiwa sistem di komputer

M

Mac OS: Sistem operasi Apple

Mb/s: megabit per detik, yang merupakan satuan kecepatan transfer data

Memory controller chip (MCC): Jembatan antara CPU dan RAM

Manajemen memori:Salah satu fungsi yang dijalankan kernel; fungsi ini mengoptimalkan penggunaan memori dan memastikan aplikasi kita memiliki memori yang cukup untuk berjalan

Metadata: Memberi tahu semua hal yang perlu diketahui tentang file, termasuk siapa yang membuatnya, kapan terakhir diubah, siapa yang memiliki akses ke file, dan jenis filenya

Port tampilan mikro: Salah satu jenis konektor daya, data, dan layar standar yang digunakan di perangkat seluler 

Microsoft Terminal Services Client: Program klien yang digunakan untuk membuat koneksi RDP ke komputer jarak jauh

Micro HDMI: Salah satu jenis konektor daya, data, dan layar standar yang digunakan di perangkat seluler 

USB Mikro: Salah satu jenis konektor daya, data, dan layar standar yang digunakan di perangkat seluler 

Mini HDMI: Salah satu jenis konektor daya, data, dan layar standar yang digunakan di perangkat seluler 

Mini USB: Salah satu jenis konektor daya, data, dan layar standar yang digunakan di perangkat seluler

Motherboard: Bodi atau sistem sirkulasi komputer yang menghubungkan semua bagian secara bersamaan

N

Northbridge: menghubungkan komponen seperti RAM dan kartu video

O

Open SSH: Program paling populer untuk menggunakan SSH dalam Linux

Open source: Ini berarti developer akan mengizinkan developer lain membagikan, mengubah, dan mendistribusikan software mereka secara gratis

Sistem operasi: Seluruh paket yang mengelola resource komputer dan memungkinkan kita berinteraksi dengannya

Overclocking: ini meningkatkan kecepatan siklus clock CPU untuk menjalankan lebih banyak tugas

P

PC:Komputer pribadi, yang secara teknis berarti komputer yang digunakan oleh satu orang

PCI Express: Peripheral Component Interconnect Express

PDA (Asisten Digital Pribadi): Memungkinkan komputasi berjalan di perangkat seluler

Periferal:perangkat eksternal yang terhubung ke komputer dan memiliki fungsi tambahan, seperti: mouse, keyboard, dan monitor

Pin Grid Array (PGA): Soket CPU yang pinnya berada di prosesor itu sendiri

Plink (PuTTY Link): Alat yang terintegrasi ke dalam command line setelah PuTTY diinstal yang digunakan untuk membuat koneksi SSH jarak jauh

Port: Titik koneksi yang dapat dihubungkan dengan perangkat untuk menambah fungsi komputer

POST (Power On Self Test): Alat ini mencari tahu hardware apa saja yang ada di komputer

Powershell: Shell (program yang menafsirkan perintah teks) untuk Windows

Catu daya: Mengonversi listrik dari stopkontak ke format yang dapat digunakan komputer

Pengguna super:Pengguna komputer di atas rata-rata

Manajemen proses:Kapasitas untuk mengelola banyak program dalam suatu sistem - kapan harus menjalankannya, bagaimana urutannya, berapa banyak resource yang dibutuhkan, berapa lama program berjalan, dll.

Program: Petunjuk dasar yang memberi tahu hal yang harus dilakukan komputer

Kartu punch: Urutan kartu dengan lubang di dalamnya untuk melakukan penghitungan secara otomatis, bukan memasukkannya secara manual dengan tangan

Q

Qwiklabs: Platform online yang menyediakan pelatihan layanan cloud

R

RAM: Random Access Memory

Register: Lokasi yang dapat diakses untuk menyimpan data yang digunakan CPU

Pembuatan ulang image:Proses pembuatan ulang image melibatkan penghapusan total dan penginstalan ulang sistem operasi yang menggunakan disk image yang merupakan salinan dari sistem operasi

Koneksi jarak jauh: Kemampuan untuk menghubungkan pengguna yang berwenang ke komputer atau jaringan dari jarak jauh; sehingga kita dapat mengelola banyak perangkat dari mana saja di seluruh dunia 

Remote Desktop Protocol (RDP): Protokol komunikasi jaringan aman yang dikembangkan oleh Microsoft dan memungkinkan pengguna untuk terhubung ke perangkat lain dari jarak jauh

Otorisasi pengembalian merchandise (RMA): Proses menerima merchandise yang dikembalikan dan memberi otorisasi untuk pengembalian dana

Model RGB: RGB atau model merah, hijau, dan biru adalah model dasar untuk merepresentasikan warna

Chip ROM (Read-Only Memory): Chip read-only memory tempat BIOS disimpan

RPM: Revolusi per menit

S

Suhu pengoperasian yang aman: Rentang suhu yang aman untuk menyimpan baterai isi ulang guna menghindari kerusakan

SATA: Drive serial ATA terpopuler, yang menggunakan satu kabel untuk transfer data

Skalabilitas: Ukuran kemampuan sistem untuk meningkatkan atau menurunkan performa dan biaya sebagai respons terhadap berbagai beban dalam permintaan pemrosesan sistem

SDRAM: Ini adalah singkatan dari Synchronous DRAM. Jenis RAM ini disinkronkan dengan kecepatan clock sistem yang memungkinkan pemrosesan data yang lebih cepat

Shell: Program yang menafsirkan perintah teks dan mengirimkannya ke OS untuk dijalankan

SOC (Sistem di Chip): Memaketkan CPU, RAM, dan bahkan terkadang penyimpanan ke dalam satu chip

Southbridge: Ini menjalankan pengontrol IO atau input/output seperti hard drive dan perangkat USB yang mengambil input dan menghasilkan output berupa data

SSD: Solid State Drive

SSH (Secure Shell): Protokol yang diimplementasikan oleh program lain untuk mengakses satu komputer dari komputer lain secara aman.

Kunci autentikasi SSH: Metode autentikasi yang aman untuk mengakses komputer dari perangkat lain

Klien SSH: Program yang harus diinstal di perangkat untuk membuat koneksi SSH dengan perangkat lain

Server SSH: Software yang diinstal di komputer yang memungkinkan perangkat tersebut untuk menerima koneksi SSH

Standardisasi: Cara sistematis untuk menamai host

Sekrup penyangga: Digunakan untuk menaikkan dan memasang motherboard ke casing

Ruang swap: Ruang yang dialokasikan tempat memori virtual disimpan di hard drive jika jumlah ruang memori fisik sudah habis atau penuh

Sistem: Sekelompok komponen hardware dan software yang bekerja sama untuk menjalankan program atau proses di komputer

Setelan sistem:Setelan seperti resolusi layar, akun pengguna, jaringan, perangkat, dll.

T

Panel tugas: Fitur ini memberikan opsi cepat dan menampilkan informasi seperti konektivitas jaringan, tanggal, notifikasi sistem, suara, dll.

Terminal: Antarmuka berbasis teks ke komputer

Pasta pendingin: Zat yang digunakan untuk menghubungkan CPU dan pembuang panas dengan lebih baik sehingga panas berpindah ke pembuang panas dengan lebih baik

Irisan waktu: Interval waktu yang sangat singkat yang dialokasikan untuk proses eksekusi CPU

Konektor Type-C: Jenis konektor USB yang dimaksudkan untuk menggantikan banyak koneksi periferal

U

Ubuntu: Distribusi konsumen Linux yang paling populer

UEFI: Unified Extensible Firmware Interface

USB (Universal Serial Bus): Standar koneksi untuk menghubungkan periferal ke perangkat seperti komputer

Adaptor USB-C: Salah satu jenis konektor daya, data, dan layar standar yang digunakan di perangkat seluler

Nama pengguna: ID unik untuk akun pengguna

Ruang pengguna: Aspek sistem operasi yang berinteraksi dengan manusia secara langsung seperti program, contohnya editor teks, pemutar musik, setelan sistem, antarmuka pengguna, dll.

UTF-8: Standar encoding yang paling umum digunakan saat ini

V

Virtual Box: Aplikasi yang dapat Anda gunakan untuk menginstal Linux dan mengisolasinya secara penuh dari komputer Anda

Virtual machine (VM): Aplikasi yang menggunakan resource fisik seperti memori, CPU, dan penyimpanan, tetapi memberikan manfaat tambahan seperti menjalankan beberapa sistem operasi sekaligus

Memori virtual: Kombinasi ruang hard drive dan RAM yang berfungsi seperti memori yang dapat digunakan oleh berbagai proses

VPN (Virtual private network): Metode aman untuk menghubungkan perangkat ke jaringan pribadi melalui internet

